20
0 0 0 0 0 0 0 0 0 0 0 0 0 0 0 140 118 0 0 75
0 0 0 0 0 211 90 0 0 0 0 0 0 100 0 0 0 85 0 0
0 0 0 120 0 0 0 0 0 0 0 0 0 124 146 0 0 0 0 0
0 0 120 0 0 0 0 0 0 0 75 0 0 0 0 0 0 0 0 0
0 0 0 0 0 0 0 86 0 0 0 0 0 0 0 0 0 0 0 0
0 211 0 0 0 0 0 0 0 0 0 0 0 0 0 99 0 0 0 0
0 90 0 0 0 0 0 0 0 0 0 0 0 0 0 0 0 0 0 0
0 0 0 0 86 0 0 0 0 0 0 0 0 0 0 0 0 98 142 0
0 0 0 0 0 0 0 0 0 0 0 87 0 0 0 0 0 0 92 0
0 0 0 0 0 0 0 0 0 0 70 0 0 0 0 0 111 0 0 0
0 0 0 75 0 0 0 0 0 70 0 0 0 0 0 0 0 0 0 0
0 0 0 0 0 0 0 0 87 0 0 0 0 0 0 0 0 0 0 0
0 0 0 0 0 0 0 0 0 0 0 0 0 0 0 151 0 0 0 71
0 100 124 0 0 0 0 0 0 0 0 0 0 0 97 0 0 0 0 0
0 0 146 0 0 0 0 0 0 0 0 0 0 97 0 80 0 0 0 0
140 0 0 0 0 99 0 0 0 0 0 0 151 0 80 0 0 0 0 0
118 0 0 0 0 0 0 0 0 111 0 0 0 0 0 0 0 0 0 0
0 85 0 0 0 0 0 98 0 0 0 0 0 0 0 0 0 0 0 0
0 0 0 0 0 0 0 142 92 0 0 0 0 0 0 0 0 0 0 0
75 0 0 0 0 0 0 0 0 0 0 0 71 0 0 0 0 0 0 0

366 0 160 242 161 178 77 151 226 244 241 234 380 98 193 253 329 80 199 374